ກປ.ອອນໄລ - ດ້ວຍຂົງເຂດໂທລະຄົມມະນາຄົມພາຍໃນປະເທດ, ກຳລັງໜູນເຕີບໂຕຕົ້ນຕໍຂອງ Viettel ປີ 2019 ແມ່ນລາຍຮັບຈາກບໍລິການດາຕ້າ.	KR Online - Với lĩnh vực viễn thông trong nước, động lực tăng trưởng chính của Viettel trong năm 2019 là doanh thu từ dịch vụ dữ liệu.
ນີ້ກໍ່ແມ່ນຂົງເຂດເຊິ່ງ Viettel ໄດ້ຮັບລາງວັນ “ບໍລິສັດສະໜອງບໍລິການດາຕ້າໂທລະສັບມືຖືດີທີ່ສຸດຢູ່ຫວຽດນາມ ປີ 2019 ຈາກອົງການຄົ້ນຄວ້າ ແລະວິເຄາະຕະຫຼາດແຖວໜ້າໂລກ Frost & Sullivan.	Đây là lĩnh vực mà Viettel đã nhận được giải thưởng “Nhà cung cấp dữ liệu dữ liệu di động tốt nhất Việt Nam 2019” do Bộ phận nghiên cứu và phân tích thị trường toàn cầu Frost & Sullivan trao tặng.
ເພື່ອປະກອບສ່ວນຍູ້ໄວວິວັດທະນາການຫັນປ່ຽນດີຈີຕອນຢູ່ຫວຽດນາມ, ກຸ່ມບໍລິສັດອຸດສາຫະກຳ-ໂທລະຄົມມະນາຄົມກອງທັບ (Viettel) ໄດ້ມີແຜນການຍູ້ແຮງ ການເພີ່ມການກະຈາຍສັນຍານ 4G ໄປທົ່ວທຸກເຂດ, ພາກຂອງປະເທດຊາດກວ່າອີກ, ໃນນັ້ນ, Viettel ໄດ້ສົມທົບກັບບັນດາບໍລິສັດຫວຽດນາມ ຈຳໜ່າຍໂທລະສັບ smartphone 4G ລາຄາບໍ່ເກີນ 1,5 ລ້ານດົ່ງ/ໜ່ວຍ ແລະ feature phone 4G ມີລາຄາປະມານ 400.000 ດົ່ງ/ໜ່ວຍ.	Để đẩy nhanh quá trình chuyển đổi số tại Việt Nam, Tập đoàn Viettel có kế hoạch đẩy nhanh việc mở rộng vùng phủ sóng 4G trên khắp mọi miền đất nước, trong đó Viettel sẽ hợp tác với các công ty Việt Nam để cung cấp điện thoại thông minh 4G / 4G trị giá dưới 1,5 triệu baht / 4G.
Viettel ໄດ້ກະຈາຍສັນຍານ 4 G ໄປທົ່ວທຸກເຂດ, ພາກຂອງປະເທດຊາດ.	Viettel đã phủ sóng 4G đến khắp mọi miền đất nước.
ພາບ: ງອັກຖຸຍ.	Ảnh: Ng Auy
ຄຽງຂ້າງນັ້ນ, Viettel ຈະສືບຕໍ່ປັບປຸງສະຖານີ 4G (ສະຖານີ 4G ກວ່າ 2.400 ແຫ່ງ) ແລະລົບລ້າງບັນດາເຂດຫຼຸບ (ສະຖານີ 4G ປະມານ 3.700 ແຫ່ງ) ເພື່ອຊ່ວຍໃຫ້ລູກຄ້າໄດ້ນຳໃຊ້ການບໍລິການ 4G ທີ່ດີກວ່າ.	Bên cạnh đó, Viettel sẽ tiếp tục hoàn thiện các trạm 4G (hơn 2.400 trạm 4G) và xóa bỏ phân khu (khoảng 3.700 trạm 4G) để giúp khách hàng sử dụng dịch vụ 4G tốt hơn.
ເປົ້າໝາຍຂອງ Viettel ມີເບີໂທ 4G ຢູ່ຫວຽດນາມ ຕື່ມອີກ 10 ລ້ານເບີ, ເພີ່ມອັດຕາສ່ວນແຕ່ 43,5% ຂຶ້ນເປັນ 62% ໃນປີ 2020.	Viettel đặt mục tiêu sẽ có thêm 10 triệu số 4G tại Việt Nam, tăng từ 43,5% lên 62% vào năm 2020.
ສິ້ນສຸດປີ 2019 ໃນຂົງເຂດໂທລະຄົມມະນາຄົມພາຍໃນປະເທດ, ກຸ່ມບໍລິສັດອຸດສາຫະກໍາ-ໂທລະຄົມມະນາຄົມກອງທັບ (Viettel) ບັນລຸລະດັບເຕີບໂຕໄດ້ 6,4% ໃນສະພາບການຕະຫຼາດຢູ່ໃນລະດັບອີ່ມຕົວ (ທົບເກືອບ 2 ເທົ່າລະດັບສະເລ່ຍຂອງໂລກ);	Kết thúc năm 2019, trong lĩnh vực viễn thông trong nước, Tập đoàn Công nghiệp - Viễn thông Quân đội (Viettel) đạt mức tăng trưởng 6,4% trong một thị trường bão hòa (gần gấp đôi mức trung bình toàn cầu);
ການລົງທຶນຕ່າງປະເທດໃນຂົງເຂດໂທລະຄົມມະນາຄົມເຕີບໂຕ 24,4% (ທົບ 6 ເທົ່າລະດັບສະເລ່ຍຂອງໂລກ).	Đầu tư nước ngoài vào lĩnh vực viễn thông tăng 24,4% (gấp sáu lần mức trung bình toàn cầu).
ດ້ວຍຂົງເຂດໂທລະຄົມມະນາຄົມພາຍໃນປະເທດ, ກຳລັງໜູນເຕີບໂຕຕົ້ນຕໍຂອງ Viettel ປີ 2019 ແມ່ນລາຍຮັບຈາກບໍລິການດາຕ້າ.	Với lĩnh vực viễn thông trong nước, mục tiêu tăng trưởng chính của Viettel năm 2019 là doanh thu từ dịch vụ dữ liệu.
ນີ້ກໍ່ແມ່ນຂົງເຂດເຊິ່ງ Viettel ໄດ້ຮັບລາງວັນ “ບໍລິສັດສະໜອງບໍລິການດາຕ້າໂທລະສັບມືຖືດີທີ່ສຸດຢູ່ຫວຽດນາມ ປີ 2019 ຈາກອົງການຄົ້ນຄວ້າ ແລະວິເຄາະຕະຫຼາດແຖວໜ້າໂລກ Frost & Sullivan.	Đây là lĩnh vực mà Viettel đã nhận được giải thưởng “Nhà cung cấp dữ liệu dữ liệu di động tốt nhất Việt Nam 2019” do Bộ phận nghiên cứu và phân tích thị trường toàn cầu Frost & Sullivan trao tặng.
ຕາມການຄາດຄະເນແລ້ວ, ດາຕ້າສືບຕໍ່ແມ່ນຂົງເຂດຈະຊ່ວຍໃຫ້ Viettel ເຕີບໂຕດ້ານໂທລະຄົມມະນາຄົມປີ 2020 ຍ້ອນລະດັບນໍາໃຊ້ຢູ່ຫວຽດນາມ ຍັງຕໍ່າເມື່ອທຽບໃສ່ພາກພື້ນກ່ຽວກັບອັດຕາຜູ້ນຳໃຊ້ກໍ່ຄືດາຕ້າ.	Theo dự đoán, data sẽ tiếp tục là khu vực giúp Viettel phát triển lĩnh vực viễn thông vào năm 2020 do mức độ sử dụng tại Việt Nam vẫn ở mức thấp so với khu vực về số lượng thuê bao.
ປະຈຸບັນ, ລາວ ແລະກຳປູເຈຍ ພວມນຳໃຊ້ປະມານ 12-15G/ຄົນ/ເດືອນ, ຢູ່ຫວຽດນາມ ຕົວເລກນີ້ຢູ່ລະດັບປານກາງແມ່ນ 5-7G/ຄົນ/ເດືອນ.	Hiện tại, Lào và Campuchia sử dụng khoảng 12-15G / người / tháng, trong khi ở Việt Nam con số này ở mức vừa phải là 5-7G / người / tháng.
ປີ 2020, Viettel ວາງເປົ້າໝາຍສ້າງກໍາໄລໃນຂົງເຂດໂທລະຄົມມະນາຄົມພາຍໃນປະເທດໃຫ້ເພີ່ມຂຶ້ນ 4,3% ເມື່ອທຽບໃສ່ປີ 2019.	Đến năm 2020, Viettel đặt mục tiêu tăng trưởng lợi nhuận trong lĩnh vực viễn thông trong nước lên 4,3% so với năm 2019.
ນີ້ແມ່ນຄາດໝາຍທີ່ເຕັມໄປດ້ວຍສິ່ງທ້າທາຍຫຼາຍຢ່າງໃນສະພາບການຕະຫຼາດໂທລະຄົມມະນາຄົມຢູ່ໃນລະດັບອີ່ມຕົວ ແລະກຳໄລຂະແໜງມີການຫຼຸດລົງ.	Đây là một dự báo rất thách thức trong bối cảnh thị trường viễn thông đang bão hòa và tỷ suất lợi nhuận ngày càng giảm.
ຄຽງຂ້າງນັ້ນ, Viettel ກໍ່ວາງເປົ້າໝາຍໃຫ້ກາຍເປັນບໍລິສັດເບີ 1 ຂອງຫວຽດນາມ ກ່ຽວກັບລາຍຮັບຈາກອິນເຕີແນັດສາຍກາບໃຍແສງໃນປີ 2020, ດ້ວຍລາຍຮັບບໍລິການຄົງທີ່ເຕີບໂຕ 23,2%.	Đồng thời, Viettel đặt mục tiêu trở thành công ty số 1 Việt Nam về doanh thu internet cáp quang vào năm 2020, với tốc độ tăng trưởng doanh thu dịch vụ ổn định 23,2%.
ໃນປີ 2019, Viettel ແມ່ນບໍລິສັດອິນເຕີແນັດແຫ່ງທໍາອິດທີ່ກະຈາຍສັນຍານ 5G ຢູ່ຫວຽດນາມ ນຳຫວຽດນາມ ລອດເຂົ້າໃນຈຳນວນກວ່າ 10 ປະເທດທຳອິດໃນໂລກກະຈາຍສັນຍານ 5G ສຳເລັດຜົນ;	Năm 2019, Viettel là công ty internet đầu tiên phát tín hiệu 5G tại Việt Nam, đưa Việt Nam trở thành một trong 10 quốc gia đầu tiên trên thế giới phát thành công tín hiệu 5G;
ນຳເຂົ້າຂຸດຄົ້ນລະບົບອິນເຕີແນັດສັບພະສິ່ງ ແລະພື້ນຖານພັດທະນາສັງຄົມດີຈີຕອນ (ນອນໃນທອັບ 50 ບໍລິສັດອິນເຕີແນັດທຳອິດໃນໂລກ)...	Giới thiệu về Internet, vạn vật và những điều cơ bản của sự phát triển xã hội số (nằm trong top 50 công ty Internet hàng đầu thế giới) ...
ກາງເດືອນມັງກອນ 2020, Viettel ໄດ້ປະຕິບັດການໂທ video ເທື່ອທໍາອິດດ້ວຍການນໍາໃຊ້ເຄືອຂ່າຍ 5G ຜ່ານອຸປະກອນໂດຍ Viettel ຜະລິດເອງໄດ້ສໍາເລັດຜົນ.	Giữa tháng 1/2020, Viettel đã thực hiện thành công cuộc gọi video đầu tiên sử dụng mạng 5G thông qua thiết bị do Viettel sản xuất.
ຕາມການຄາດຄະເນ, Viettel ຈະຫັນ 5G Microcell ເປັນການຄ້າໃນເດືອນມີຖຸນາ 2020 ແລະເດືອນມີຖຸນາ 2021 ຈະຫັນ 5 G Microcell ເປັນການຄ້າໃນທົ່ວລະບົບເຄືອຂ່າຍ.	Viettel dự kiến sẽ thương mại hóa 5G Microcell vào tháng 6/2020 và tháng 6/2021 sẽ thương mại hóa 5G Microcell.
ໂດຍ: ແສງເດືອນ.	Bởi: Moonlight.
